11111111          11111
15555551111111    15551
15555555555551    15551
111111111111551    250
            1551   151
             151   151
             354111151
             155555551
             250111111
             1551
             1111