33333333333333      1111111111111
15555555555551      1555555555551
11135555555551      1555555555551
15511455555551      1555555555551
15555555555551      1111551111111
15555550111111         2550
15555555555551         1551
111111111111551        1551
            151        1551
            1551        1551
            3554111111111551
            5555555555555551
            111111111111111