5555111111
5555555551  11111111
5555555551  15555551111111
 11111511   15555555555551
     151    15511111111111
     151    151
     151    151
     1511111354
     1555555551
     1111111111