
        5555555  11111111
        5555555  15555551111111
        111511   15555555555551
          151    15511111111111
          151    151
          151    151
          1511111354
          1555555551
          1111111111