55333333333333
15555555555551
11135555555551
15511455555551
15555555555551
15555550111111
15555555555551
11111111111111