011111111112
1          1
1113       1
1  411     1
1          1
1      01111
1          1
1          1
111112     1
1          1
1          1
411111111113