
        5555555  11111111
        5555555  1555555111
        1115111  1555555551
          151    1551111111
          151    151
          151    151
          1511111354
          1555555551
          1111111111