
    55555555   11111111111111111
    55515515   15551555555555551
      11551111115555555555115551
       1551111111551551555555551
        155155551551111111111111
         1515555155155555551
         1511511354111155551
         1555555555555115555
         1111551111111155551
         5551555555555555551
