
    55555555   1111111111111
    55515515   1555155555551
      1155111111555555555551
       155111111155155155551
        15515555155111111111
         15155551551
         15115113541111
         15555555555551
         11111111111111
