    11111
    15551   11111111
    15551   15555551111111
     250    15555555555551
     151    15511111111111
     151    151
     151    151
     1511111354
     1555555551
     1111111111