  333333333333
1            1
1113         1
1  114       1
1            1
1      0111111
1            1
11111111111111